NO img/img.xpm

SO img/img.xpm

WE img/img.xpm

EA img/img.xpm

F 20,100,12
C 225,30,0
                       
    1111111111111111111111111                                 
    1000000000110001000000001      
    1                       1
    
    1011000001110011100000001   
    1001000000000001000000001   
    1111111110110000011100001
    10000000001100000111011111111
    11110111111111011100000000001
    11110111111111011101010011111
    1100000011010101110000001
    1000000000000000110000001
    1000000000000001101010111
    1100000111010101111101111
    1111011101110101010111101
    1111111111111111111111111
