NO img/img.xpm

SO img/img.xpm
 
WE img/img.xpm

EA img/img.xpm

C 225,30,0
F 20,100,12

   
1111111111111111111111111      111
1000000000110000000000001       101
1011000001110000000000001       111
100100000000000000E00000111111111
111111111011000001110000000000001
100000000011000001110111111111111
111101111111110111000000010001
11110111111111011101010010001
11000000110101011100000010001
10000000000000001100000010001
10000000000000001101010010001
1100000111010101111101111000111
11110111 1110101 101111010001
11111111 1111111 111111111111

